111111
1E0001
1C0001
1P00P1
1000E1
111111