11111
1C0E1
10001
101P1
11111
