1111111111
10C0100001
1010101001
1P100010E1
1111111111